1111111111111111111111111111111111111111111111111111111111111111111111111111111111111111111111111111
1111111111111111111110000000001111111111111111111111111111100000001111111111111111111111111111111111
1111111111111111111110000000001111111111111111111111111111100000000111111111111111111111111111111111
1111111111111111111110000000001111111111111111111111111111100000000011111111111111111111111111111111
1111111111111111111100000000001111111111111111111111111111000000000011111111111111111111111111111111
1111111111111111111000000000000111111111111111111111111111000000000001111111111111111111111111111111
1111111111111111111000000000000111111111111111111111111111000000000000111111111111111111111111111111
1111111111111111111000000000000111111111111111111111111110000000000000111111111111111111111111111111
1111111111111111111000000000000011111111111111111111111100000000000000011111111111111111111111111111
1111111111111111110000000000000011111111111111111111111100000000000000001111111111111111111111111111
1111111111111111110000000000000011111111111111111111111000000000000000001111111111111111111111111111
1111111111111111100000000000000011111111111111111111111000000000000000000111111111111111111111111111
1111111111111111100000000000000011111111111111111111110000000000000000000011111111111111111111111111
1111111111111111000000000000000111111111111111111111100000000000000000000001111111111111111111111111
1111111111111111000000000000000111111111111111111111000000000000000000000000111111111111111111111111
1111111111111110000000000000000111111111111111111111000000000000000000000000111111111111111111111111
1111111111111000000000000000001111111111111111111110000000000000000000000000011111111111111111111111
1111111111100000000000000000011111111111111111111110000000000111111111000000001111111111111111111111
1111111110000000000000000000111111111111111111111100000000001111111111110000000111111111111111111111
1111111100000000000000000000111111111111111111111000000000111111111111111000000001111111111111111111
1111111000000000000000000011111111111111111111100000000000111111111111111000000000111111111111111111
1111100000000000000000000011111111111111111111000000000000111111111111111100000000000011111111111111
1100000000000000000000000011111111111111111000000000000000111111111111111100000000000000111111111111
1000000000000000000000000011111111111111110000000000000000111111111111111110000000000000011111111111
1000000000000000000000000011111111111111100000000000000000111111111111111110000000000000001111111111
1000000000000000000000000011111111111111100000000000000000011111111111111111000000000000001111111111
1000000000000000000000000011111111111111100000000000000000011111111111111111000000000000000111111111
1000000000000000000000000001111111111111100000000000000000001111111111111111100000000000000001111111
1000000000000000000000000001111111111111100000000000000000001111111111111111100000000000000000111111
1000000000000000000000000011111111111111100000000000000000001111111111111111110000000000000000011111
1000000000000000000000000011111111111111100000000000000000001111111111111111111000000000000000011111
1000000000000000000000000011111111111111100000000000000000011111111111111111111100000000000000011111
1000000000000000000000000111111111111111110000000000000000011111111111111111111100000000000000011111
1000000000000000000000000111111111111111110000000000000000111111111111111111111110000000000000011111
1000000000000000000000000111111111111111111000000000000001111111111111111111111111000000000000011111
1000000000000000000000000111111111111111111100000000000011111111111111111111111111000000000000111111
1000000000000000000000001111111111111111111100000000000111111111111111111111111111100000000001111111
1000000000000000000000011111111111111111111110000000011111111111111111111111111111110000000001111111
1000000000000000000000111111111111111111111111000001111111111111111111111111111111110000000001111111
1000000000000000000001111111111111111111111111100011111111111111111111111111111111111000000011111111
1000000000000000001111111111111111111111111111110011111111111111111111111111111111111000000011111111
1000000000000000011111111111111111111111111111110001111111111111111111111111111111111000000011111111
1100000000000000111111111111111111111111111111110001111111111111111111111111111111111100000011111111
1110000000000000111111111111111111111111111111110000111111111111111111111111111111111100000111111111
1111000000000000111111111111111111111111111111110000111111111111111111111111111111111100000111111111
1111000000000001111111111111111111111111111111110000011111111111111111111111111111111100000111111111
1111100000000001111111111111111000001111111111110000011111111111111111111111111111111100000111111111
1111110000000001111111111110000000000001111111110000001111111111111111111111111111111100000111111111
1111111000000001111111111100000000000000111111000000001111111111111111111111111111111100000111111111
1111111000000000111111111000000000000000001110000000000111111111111111111111111111111000000111111111
1111111100000000011111110000000000000000000000000000000111111111111111111111111111111000000111111111
1111111100000000011111100000000000000000000000000000000111111111111111111111111111111000000011111111
1111111110000000000000000000000000000000000000000000000111111111111111111111111111111000000011111111
1111111110000000000000000000000000000000000000000000000111111111111111111111111111110000000011111111
1111111110000000000000000000000000000000000000000000000111111111111111111111111111110000000001111111
1111111110000000000000000000000000000000000000000000000111111111111111111111111111110000000001111111
1111111110000000000000000000000000000000000000000000011111111111111111111111111111110000000001111111
1111111110000000000000000000000110000000000000000000011111111111111111111111111111100000000001111111
1111111111000000000000000000111111111000000000000000111111111111111111111111111111100000000001111111
1111111111000000000000000001111111111100000000000000111111111111111111111111111111100000000001111111
1111111111000000000000000111111111111110000000000001111111111111111111111111111111000000000000111111
1111111111000000000000000111111111111111000000000001111111111111111111111111111111000000000000111111
1111111111000000000000000111111111111111100000000001111111111111111111111111111110000000000000111111
1111111111000000000000000111111111111111100000000011111111111111111111111111111100000000000001111111
1111111111100000000000000111111111111111100000000111111111111111111111111111111000000000000001111111
1111111111100000000000000111111111111111100000001111111111111111111111111111110000000000000001111111
1111111111110000000000001111111111111111100000011111111111111111111111111111100000000000000011111111
1111111111111000000000001111111111111111110000011111111111111111111111111111000000000000000011111111
1111111111111100000000001111111111111111110000011111111111111111111111111111000000000000000011111111
1111111111111110000000001111111111111111110000001111111111111111111111111110000000000000000011111111
1111111111111110000000001111111111111111110000000111111111111111111111111110000000000000000011111111
1111111111111111000000001111111111111111110000000111111111111111111111111100000000000000000111111111
1111111111111111100000001111111111111111111000000011111111111111111111111100000000000000011111111111
1111111111111111110000000111111111111111111000000001111111111111111111111000000000000001111111111111
1111111111111111111000000111111111111111111100000000111111111111111111110000000000000011111111111111
1111111111111111111000000011111111111111111100000000011111111111111110000000000000000111111111111111
1111111111111111111000000011111111111111111110000000000011111111111100000000000000000111111111111111
1111111111111111111000000011111111111111111111000000000000011111110000000000000000000111111111111111
1111111111111111111000000001111111111111111111000000000000000000000000000000000000000111111111111111
1111111111111111111000000001111111111111111111100000000000000000000000000000000000001111111111111111
1111111111111111111000000000111111111111111111110000000011111111100000000000000000011111111111111111
1111111111111111110000000000011111111111111111111000000011111111111000000000000001111111111111111111
1111111111111111110000000000011111111111111111111100000011111111111000000000001111111111111111111111
1111111111111111110000000000001111111111111111111110000011111111111000000000011111111111111111111111
1111111111111111110000000000000111111111111111111111000011111111111000000000011111111111111111111111
1111111111111111110000000000000111111111111111111111100001111111111000000000011111111111111111111111
1111111111111111110000000000000011111111111111111111100000111111111000000000011111111111111111111111
1111111111111111110000000000000011111111111111111111110000011111110000000000011111111111111111111111
1111111111111111110000000000000001111111111111111111110000000111000000000000011111111111111111111111
1111111111111111100000000000000000111111111111111111111000000000000000000000011111111111111111111111
1111111111111111100000000000000000011111111111111111111100000000000000000000011111111111111111111111
1111111111111111100000000000000000001111111111111111111111000000000000000000011111111111111111111111
1111111111111111100000000000000000001111111111111111111111110000000000000000001111111111111111111111
1111111111111111100000000000000000001111111111111111111111111100000000000000001111111111111111111111
1111111111111111100000000000000000001111111111111111111111111111110000000000011111111111111111111111
1111111111111111100000000000000000001111111111111111111111111111111000000000011111111111111111111111
1111111111111111100000000000000000001111111111111111111111111111111100000000011111111111111111111111
1111111111111111100000000000000000011111111111111111111111111111111110000000001111111111111111111111
1111111111111111100000000000000000111111111111111111111111111111111111110000001111111111111111111111
1111111111111111111111111111111111111111111111111111111111111111111111111111111111111111111111111111