11111111111111110
10000000000000011
10000000000000331
10000000001111111
10000000000000331
10000000000000001
10000000000000001
13333333333000031
10000000000000001
10000000000000001
100000000000000022
100022200000000002
1000022000000000022
1000002000000000002
1000000000000000022
100000000000000022
10000000000000001
10000000004000001
10000000000000001
10000000000000001
10000011111111111
5000005
5000005
5555555
