11111111111000
10000000001110
10000000000011
10000111000001
10000111000001
10000111000001
10000000000001
11100000000001
10000000000001
10000000000001
11111110000001
00000010000001
00000011111111